####################
#                  #
#   xxxxxxxxxxxx   #
#   vvvvvvvvvvvv   #
#   xxvvvvvvvvxx   #
#   xxxxxvvxxxxx   #
#                  #
#                  #
#                  #
#                  #
#                  #
#                  #
#                  #
#                  #
#                  #
#                  #
#                  #
#                  #
#         ^        #
####################