####################
#                  #
#   xxxxxxxxxxxx   #
#   xxvxxvvxxvxx   #
#   vvxvvxxvvxvv   #
#   xxxxxxxxxxxx   #
#                  #
#                  #
#                  #
#                  #
#                  #
#                  #
#                  #
#                  #
#                  #
#                  #
#                  #
#                  #
#         ^        #
####################
